simulation_id,Train_method,Test_method,A_is_random,B_is_random,A_wins,B_wins,draws,terminated_games,avg_match_length
1,vs_random,not_include_draws,False,True,8166,363,0,8529,11.724352210106694
1,vs_random,include_draws,False,True,5933,103,10012,6036,7.865639496355202
1,vs_belief,not_include_draws,False,False,4850,3639,0,8489,11.779597125692073
1,vs_belief,not_include_draws,False,True,5170,541,0,5711,17.503414463316407
1,vs_belief,not_include_draws,True,False,413,3073,0,3486,28.68273092369478
1,vs_belief,include_draws,False,False,3400,1977,9891,5377,8.935465873163475
1,vs_belief,include_draws,False,True,5220,176,9904,5396,6.872127501853225
1,vs_belief,include_draws,True,False,139,1766,9960,1905,12.711811023622047
2,vs_random,not_include_draws,False,True,8378,371,0,8749,11.429191907646588
2,vs_random,include_draws,False,True,6204,85,9970,6289,7.774367944029257
2,vs_belief,not_include_draws,False,False,5799,5444,0,11243,8.89406741972783
2,vs_belief,not_include_draws,False,True,3560,509,0,4069,24.562546080117965
2,vs_belief,not_include_draws,True,False,525,3611,0,4136,24.14627659574468
2,vs_belief,include_draws,False,False,4859,4527,9890,9386,5.895269550394204
2,vs_belief,include_draws,False,True,2648,128,9857,2776,10.226945244956772
2,vs_belief,include_draws,True,False,191,3301,9944,3492,8.601374570446735
3,vs_random,not_include_draws,False,True,8526,554,0,9080,11.013215859030836
3,vs_random,include_draws,False,True,7579,167,10015,7746,6.268009295120062
3,vs_belief,not_include_draws,False,False,4303,4401,0,8704,11.488396139705882
3,vs_belief,not_include_draws,False,True,3675,491,0,4166,24.00192030724916
3,vs_belief,not_include_draws,True,False,444,3142,0,3586,27.880368098159508
3,vs_belief,include_draws,False,False,2697,3250,10011,5947,8.119387926685723
3,vs_belief,include_draws,False,True,3294,152,10063,3446,8.894080092861289
3,vs_belief,include_draws,True,False,135,2230,10122,2365,10.984355179704018
4,vs_random,not_include_draws,False,True,8347,470,0,8817,11.34138595894295
4,vs_random,include_draws,False,True,6674,166,10068,6840,7.026023391812865
4,vs_belief,not_include_draws,False,False,3892,3944,0,7836,12.761485451761102
4,vs_belief,not_include_draws,False,True,4393,451,0,4844,20.641824938067714
4,vs_belief,not_include_draws,True,False,472,3605,0,4077,24.524895756683836
4,vs_belief,include_draws,False,False,2410,2610,9884,5020,9.074900398406374
4,vs_belief,include_draws,False,True,2806,144,9980,2950,10.846101694915255
4,vs_belief,include_draws,True,False,169,2643,10086,2812,10.197724039829303
5,vs_random,not_include_draws,False,True,6802,490,0,7292,13.713384530992869
5,vs_random,include_draws,False,True,5360,120,10064,5480,8.009671532846715
5,vs_belief,not_include_draws,False,False,4528,4137,0,8665,11.540565493364108
5,vs_belief,not_include_draws,False,True,3336,314,0,3650,27.376986301369865
5,vs_belief,not_include_draws,True,False,477,4643,0,5120,19.5251953125
5,vs_belief,include_draws,False,False,2636,3412,10213,6048,7.867724867724868
5,vs_belief,include_draws,False,True,1728,148,10038,1876,13.085287846481876
5,vs_belief,include_draws,True,False,165,3832,9848,3997,8.686765073805354
6,vs_random,not_include_draws,False,True,7100,474,0,7574,13.202534988117243
6,vs_random,include_draws,False,True,5218,166,10032,5384,8.177563150074294
6,vs_belief,not_include_draws,False,False,5012,4084,0,9096,10.993403693931398
6,vs_belief,not_include_draws,False,True,4577,496,0,5073,19.70944214468756
6,vs_belief,not_include_draws,True,False,470,3282,0,3752,26.645255863539447
6,vs_belief,include_draws,False,False,3702,2641,10071,6343,7.8155446949393035
6,vs_belief,include_draws,False,True,4216,135,9943,4351,8.1774304757527
6,vs_belief,include_draws,True,False,164,2433,9874,2597,10.538698498267232
7,vs_random,not_include_draws,False,True,7607,501,0,8108,12.333127775037001
7,vs_random,include_draws,False,True,5787,165,9897,5952,7.654905913978495
7,vs_belief,not_include_draws,False,False,2854,3053,0,5907,16.929067208396816
7,vs_belief,not_include_draws,False,True,3636,379,0,4015,24.904607721046077
7,vs_belief,not_include_draws,True,False,458,2920,0,3378,29.599467140319717
7,vs_belief,include_draws,False,False,1972,1374,9894,3346,11.157800358637179
7,vs_belief,include_draws,False,True,2495,102,9955,2597,11.003850596842511
7,vs_belief,include_draws,True,False,176,1987,10053,2163,11.31530282015719
8,vs_random,not_include_draws,False,True,7995,511,0,8506,11.755936985657183
8,vs_random,include_draws,False,True,6833,185,9965,7018,6.658022228555144
8,vs_belief,not_include_draws,False,False,3341,3080,0,6421,15.57078336707678
8,vs_belief,not_include_draws,False,True,4437,427,0,4864,20.55921052631579
8,vs_belief,not_include_draws,True,False,393,3466,0,3859,25.912930811090956
8,vs_belief,include_draws,False,False,2097,1485,10030,3582,10.706588498045784
8,vs_belief,include_draws,False,True,3340,166,9942,3506,9.327438676554477
8,vs_belief,include_draws,True,False,138,2284,10239,2422,11.0532617671346
9,vs_random,not_include_draws,False,True,8560,381,0,8941,11.181970696790069
9,vs_random,include_draws,False,True,6752,138,9964,6890,7.142815674891146
9,vs_belief,not_include_draws,False,False,6050,2858,0,8908,11.225752132914234
9,vs_belief,not_include_draws,False,True,3436,474,0,3910,25.57314578005115
9,vs_belief,not_include_draws,True,False,401,2757,0,3158,31.651994933502216
9,vs_belief,include_draws,False,False,4904,1189,9928,6093,8.043164286886592
9,vs_belief,include_draws,False,True,2392,162,9957,2554,10.813234142521535
9,vs_belief,include_draws,True,False,157,1406,10099,1563,13.008317338451695
10,vs_random,not_include_draws,False,True,7476,442,0,7918,12.628441525637788
10,vs_random,include_draws,False,True,5665,131,10140,5796,7.833505866114562
10,vs_belief,not_include_draws,False,False,4796,4481,0,9277,10.77783766303762
10,vs_belief,not_include_draws,False,True,3371,549,0,3920,25.50561224489796
10,vs_belief,not_include_draws,True,False,533,3158,0,3691,27.092928745597398
10,vs_belief,include_draws,False,False,4665,3058,10062,7723,6.554706720186456
10,vs_belief,include_draws,False,True,3420,171,10036,3591,7.938735728209412
10,vs_belief,include_draws,True,False,182,2321,10032,2503,10.822213343987215
