simulation_id,Train_method,Test_method,A_is_random,B_is_random,A_wins,B_wins,draws,terminated_games,avg_match_length
1,vs_random,not_include_draws,True,True,466,501,0,967,103.38986556359876
1,vs_random,include_draws,True,True,171,176,9974,347,16.178674351585013
1,vs_random,not_include_draws,False,True,5970,534,0,6504,15.373616236162361
1,vs_random,include_draws,False,True,4485,161,10203,4646,8.59169177787344
1,vs_belief,not_include_draws,False,False,4157,3923,0,8080,12.37549504950495
1,vs_belief,not_include_draws,False,True,3097,480,0,3577,27.943528096169974
1,vs_belief,not_include_draws,True,False,443,2836,0,3279,30.488258615431533
1,vs_belief,include_draws,False,False,2696,2907,10106,5603,8.089416384079957
1,vs_belief,include_draws,False,True,2556,182,9984,2738,9.758582907231556
1,vs_belief,include_draws,True,False,146,2269,9986,2415,10.319668737060042
2,vs_random,not_include_draws,True,True,507,500,0,1007,99.25521350546177
2,vs_random,include_draws,True,True,170,194,10090,364,16.78021978021978
2,vs_random,not_include_draws,False,True,6876,321,0,7197,13.893427817146033
2,vs_random,include_draws,False,True,5163,116,10050,5279,7.90339079371093
2,vs_belief,not_include_draws,False,False,3738,4207,0,7945,12.586532410320956
2,vs_belief,not_include_draws,False,True,4014,406,0,4420,22.62262443438914
2,vs_belief,not_include_draws,True,False,378,2313,0,2691,37.14901523597176
2,vs_belief,include_draws,False,False,2576,2458,9892,5034,8.886174016686532
2,vs_belief,include_draws,False,True,3198,135,10082,3333,9.152415241524153
2,vs_belief,include_draws,True,False,123,1046,10080,1169,14.660393498716852
3,vs_random,not_include_draws,True,True,482,482,0,964,103.72717842323651
3,vs_random,include_draws,True,True,199,165,9950,364,15.637362637362637
3,vs_random,not_include_draws,False,True,6087,428,0,6515,15.347659247889485
3,vs_random,include_draws,False,True,4281,158,9952,4439,8.97431854021176
3,vs_belief,not_include_draws,False,False,3632,4097,0,7729,12.937896234959245
3,vs_belief,not_include_draws,False,True,4173,479,0,4652,21.493766122098023
3,vs_belief,not_include_draws,True,False,452,2958,0,3410,29.31935483870968
3,vs_belief,include_draws,False,False,2363,2710,10073,5073,8.664695446481373
3,vs_belief,include_draws,False,True,3825,161,9861,3986,8.074009031610638
3,vs_belief,include_draws,True,False,127,2513,10187,2640,9.659469696969698
4,vs_random,not_include_draws,True,True,480,517,0,997,100.25376128385156
4,vs_random,include_draws,True,True,176,164,9967,340,16.83235294117647
4,vs_random,not_include_draws,False,True,6553,437,0,6990,14.305579399141632
4,vs_random,include_draws,False,True,4613,145,10017,4758,8.781000420344682
4,vs_belief,not_include_draws,False,False,3902,3847,0,7749,12.904632855852368
4,vs_belief,not_include_draws,False,True,3504,515,0,4019,24.881313759641703
4,vs_belief,not_include_draws,True,False,460,3198,0,3658,27.32750136686714
4,vs_belief,include_draws,False,False,2610,2643,10075,5253,8.357700361698077
4,vs_belief,include_draws,False,True,2402,150,10079,2552,10.681426332288401
4,vs_belief,include_draws,True,False,155,2548,10091,2703,9.539030706622272
5,vs_random,not_include_draws,True,True,469,510,0,979,102.08171603677222
5,vs_random,include_draws,True,True,163,175,10157,338,16.27810650887574
5,vs_random,not_include_draws,False,True,5649,468,0,6117,16.340526401830964
5,vs_random,include_draws,False,True,4250,157,9912,4407,8.687769457680963
5,vs_belief,not_include_draws,False,False,2935,4444,0,7379,13.548312779509418
5,vs_belief,not_include_draws,False,True,2889,509,0,3398,29.414067098293113
5,vs_belief,not_include_draws,True,False,497,3802,0,4299,23.250058153058852
5,vs_belief,include_draws,False,False,1689,3591,10021,5280,8.20094696969697
5,vs_belief,include_draws,False,True,1853,155,10080,2008,11.0851593625498
5,vs_belief,include_draws,True,False,160,3349,9980,3509,8.914220575662583
6,vs_random,not_include_draws,True,True,497,516,0,1013,98.66436327739387
6,vs_random,include_draws,True,True,176,147,9920,323,16.609907120743035
6,vs_random,not_include_draws,False,True,6054,501,0,6555,15.254614797864226
6,vs_random,include_draws,False,True,4700,162,10162,4862,8.30028794734677
6,vs_belief,not_include_draws,False,False,3789,3395,0,7184,13.919682628062361
6,vs_belief,not_include_draws,False,True,3015,425,0,3440,29.05639534883721
6,vs_belief,not_include_draws,True,False,408,2893,0,3301,30.28445925477128
6,vs_belief,include_draws,False,False,2600,1896,9999,4496,9.45685053380783
6,vs_belief,include_draws,False,True,1697,161,10039,1858,12.855758880516685
6,vs_belief,include_draws,True,False,164,1700,9919,1864,11.821888412017167
7,vs_random,not_include_draws,True,True,486,484,0,970,103.059793814433
7,vs_random,include_draws,True,True,168,188,9904,356,16.626404494382022
7,vs_random,not_include_draws,False,True,6639,436,0,7075,14.133427561837456
7,vs_random,include_draws,False,True,4401,184,9938,4585,8.95856052344602
7,vs_belief,not_include_draws,False,False,3834,3659,0,7493,13.34538902976111
7,vs_belief,not_include_draws,False,True,3264,489,0,3753,26.639754862776446
7,vs_belief,not_include_draws,True,False,528,3511,0,4039,24.75340430799703
7,vs_belief,include_draws,False,False,2327,2690,10140,5017,8.705800279051227
7,vs_belief,include_draws,False,True,2393,158,9880,2551,10.828694629557036
7,vs_belief,include_draws,True,False,148,3047,9802,3195,9.14866979655712
8,vs_random,not_include_draws,True,True,503,506,0,1009,99.0346878097126
8,vs_random,include_draws,True,True,166,169,10058,335,16.208955223880597
8,vs_random,not_include_draws,False,True,5149,499,0,5648,17.696529745042493
8,vs_random,include_draws,False,True,3919,174,10084,4093,8.94307354019057
8,vs_belief,not_include_draws,False,False,4346,3100,0,7446,13.425866236905721
8,vs_belief,not_include_draws,False,True,2897,385,0,3282,30.456429006703228
8,vs_belief,not_include_draws,True,False,501,3524,0,4025,24.843229813664596
8,vs_belief,include_draws,False,False,2544,2674,9977,5218,8.42276734380989
8,vs_belief,include_draws,False,True,1829,116,9840,1945,11.834961439588689
8,vs_belief,include_draws,True,False,151,3406,10072,3557,8.473151532190048
9,vs_random,not_include_draws,True,True,467,477,0,944,105.89724576271186
9,vs_random,include_draws,True,True,170,192,10072,362,16.58839779005525
9,vs_random,not_include_draws,False,True,6488,479,0,6967,14.353236687239844
9,vs_random,include_draws,False,True,5143,165,10058,5308,7.774679728711379
9,vs_belief,not_include_draws,False,False,5153,5210,0,10363,9.64865386471099
9,vs_belief,not_include_draws,False,True,3519,497,0,4016,24.900398406374503
9,vs_belief,not_include_draws,True,False,466,3161,0,3627,27.53846153846154
9,vs_belief,include_draws,False,False,3895,3679,10020,7574,6.976366517031951
9,vs_belief,include_draws,False,True,3083,201,9943,3284,9.039281364190012
9,vs_belief,include_draws,True,False,156,2410,10002,2566,9.948947778643804
10,vs_random,not_include_draws,True,True,488,501,0,989,101.09504550050556
10,vs_random,include_draws,True,True,166,163,10019,329,16.462006079027354
10,vs_random,not_include_draws,False,True,6158,506,0,6664,15.005402160864346
10,vs_random,include_draws,False,True,4938,130,10017,5068,8.112273086029992
10,vs_belief,not_include_draws,False,False,4564,4071,0,8635,11.580428488708744
10,vs_belief,not_include_draws,False,True,2237,309,0,2546,39.26472898664572
10,vs_belief,not_include_draws,True,False,453,4346,0,4799,20.83454886434674
10,vs_belief,include_draws,False,False,3334,3080,10025,6414,7.300280636108512
10,vs_belief,include_draws,False,True,1761,125,9899,1886,10.002120890774124
10,vs_belief,include_draws,True,False,154,3756,10012,3910,8.398976982097187
